species	lmax	amax
Abramis brama	48.3333333333333	NA
Acanthobrama terraesanctae	23	23.5
Acanthochaenus luetkenii	NA	NA
Acanthocybium solandri	200	NA
Acanthopagrus australis	65	NA
Acanthopagrus berda	56	NA
Acanthopagrus bifasciatus	39.5	NA
Acanthopagrus latus	50	NA
Acanthurus bahianus	27.5	NA
Acanthurus chirurgus	32	NA
Acanthurus coeruleus	33	NA
Acanthurus nigrofuscus	NA	NA
Acanthurus triostegus	16	NA
Acentrogobius lentiginosus	NA	NA
Achirus mazatlanus	NA	NA
Acipenser fulvescens	150	NA
Acipenser gueldenstaedtii	235	NA
Acipenser medirostris	203	NA
Acipenser nudiventris	NA	NA
Acipenser ruthenus	NA	NA
Acipenser stellatus	NA	NA
Acipenser transmontanus	NA	NA
Agonus cataphractus	NA	NA
Albula vulpes	67.5	NA
Alectis indicus	101.5	NA
Alepes djedaba	NA	NA
Alepes melanoptera	NA	NA
Alepocephalus rostratus	NA	NA
Alepocephalus tenebrosus	NA	NA
Alestes baremoze	27.4875	NA
Alestes dentex	30.45	NA
Alestes macrophthalmus	NA	NA
Alestes sadleri	NA	NA
Alopias vulpinus	276	NA
Alosa alosa	64.3	NA
Alosa fallax	NA	NA
Alosa pontica	37.5	NA
Alosa pseudoharengus	NA	NA
Alosa saposhnikovi	NA	NA
Ambassis agassizi	NA	NA
Ambassis gymnocephalus	NA	NA
Ambassis kopsii	NA	NA
Amblygaster sirm	23.75	3.2
Amblyopsis rosae	NA	NA
Amblyopsis spelaea	NA	NA
Amblypharyngodon melettinus	NA	NA
Amblyraja radiata	NA	NA
Ameiurus nebulosus	45	NA
Amia calva	NA	NA
Ammodytes dubius	NA	9
Ammodytes marinus	19.75	NA
Ammodytes personatus	NA	NA
Ammodytes tobianus	18.5	7
Amphiprion chrysopterus	NA	NA
Amphiprion melanopus	NA	NA
Amphiprion perideraion	NA	NA
Amphiprion tricinctus	NA	NA
Amphistichus argenteus	NA	NA
Anarhichas denticulatus	150	NA
Anarhichas lupus	NA	NA
Anarhichas minor	180	NA
Anchoa mundeola	NA	NA
Anchoa nasus	NA	NA
Anchoa panamensis	15	NA
Anguilla anguilla	145	NA
Anguilla japonica	NA	NA
Anodontostoma chacunda	NA	NA
Anoplogaster cornuta	NA	NA
Anoplopoma fimbria	NA	NA
Anotopterus pharao	NA	NA
Antimora rostrata	NA	NA
Apeltes quadracus	NA	NA
Aphanopus carbo	NA	NA
Aphareus rutilans	NA	NA
Aphia minuta	6.95	NA
Apogon cyanosoma	NA	NA
Apogon imberbis	NA	NA
Aprion virescens	110	NA
Apsilus dentatus	55	NA
Archosargus probatocephalus	59	NA
Archosargus rhomboidalis	NA	NA
Argentina sialis	21	NA
Argentina silus	NA	NA
Argentina sphyraena	24.3	NA
Argyropelecus affinis	NA	NA
Argyrops filamentosus	38	NA
Argyrops spinifer	35	NA
Argyrosomus hololepidotus	200	NA
Argyrosomus inodorus	127	NA
Argyrosomus regius	182	NA
Argyrozona argyrozona	90	NA
Ariomma indica	NA	NA
Aristichthys nobilis	NA	NA
Aristostomias scintillans	NA	NA
Arius dussumieri	NA	NA
Arius guatemalensis	NA	NA
Arius heudelotii	NA	NA
Arius tenuispinis	NA	NA
Arius thalassinus	79	NA
Arius thunbergi	NA	NA
Arnoglossus laterna	14	NA
Arripis trutta	89	7
Arripis truttacea	80	NA
Atherina presbyter	14	NA
Atractoscion aequidens	NA	NA
Atractoscion nobilis	NA	NA
Atrobucca nibe	NA	NA
Atule mate	NA	NA
Auchenoglanis occidentalis	NA	NA
Austroglossus microlepis	NA	NA
Austroglossus pectoralis	45	NA
Auxis rochei rochei	58	NA
Auxis thazard thazard	53	NA
Bagrus bajad	NA	NA
Bagrus docmak	93	NA
Bagrus meridionalis	93.5	NA
Bairdiella chrysoura	NA	NA
Balistes carolinensis	56	NA
Balistes vetula	57	NA
Barbus aeneus	NA	NA
Barbus brachycephalus brachycephalus	NA	NA
Barbus bynni bynni	NA	NA
Barbus holotaenia	12	NA
Barbus liberiensis	11.9	NA
Barbus paludinosus	11.6	NA
Barbus sclateri	35.5	NA
Barbus trimaculatus	15.5	NA
Bathophilus flemingi	NA	NA
Bathylagus pacificus	NA	NA
Bathypterois mediterraneus	NA	NA
Benthalbella linguidens	NA	NA
Benthosema fibulatum	10	NA
Benthosema glaciale	NA	NA
Benthosema pterotum	NA	NA
Benthosema suborbitale	3	NA
Beryx splendens	56.7	NA
Blicca bjoerkna	NA	NA
Bolbometopon muricatum	NA	NA
Boops boops	NA	NA
Boreogadus saida	NA	NA
Borostomias panamensis	NA	NA
Bostockia porosa	NA	NA
Boulengerochromis microlepis	52	NA
Brachydeuterus auritus	24	NA
Branchiostegus argentatus	NA	NA
Branchiostegus auratus	NA	NA
Branchiostegus japonicus	NA	NA
Brevoortia patronus	NA	NA
Brevoortia tyrannus	47	NA
Brosme brosme	NA	NA
Brotula barbata	NA	NA
Brycinus imberi	17	NA
Brycinus leuciscus	NA	NA
Brycinus nurse	NA	NA
Brycon guatemalensis	58	NA
Calamus leucosteus	41	NA
Calamus nodosus	54	NA
Callionymus belcheri	10	NA
Callionymus lyra	30	5
Callorhinchus milii	86.5	NA
Calotomus spinidens	NA	NA
Capoeta capoeta	NA	NA
Carangoides armatus	NA	NA
Carangoides ferdau	NA	NA
Carangoides malabaricus	NA	NA
Caranx bucculentus	NA	NA
Caranx crysos	NA	NA
Caranx ignobilis	166	NA
Caranx lugubris	NA	NA
Caranx melampygus	100	NA
Caranx rhonchus	NA	NA
Caranx ruber	NA	NA
Caranx sexfasciatus	80	NA
Carassius auratus auratus	30.5	NA
Carassius carassius	38.5	NA
Carassius gibelio	NA	NA
Carcharhinus amblyrhynchos	NA	NA
Carcharhinus brachyurus	297.5	NA
Carcharhinus falciformis	312.75	NA
Carcharhinus galapagensis	NA	NA
Carcharhinus leucas	320	NA
Carcharhinus limbatus	178.5	NA
Carcharhinus obscurus	320.4	NA
Carcharhinus plumbeus	183.333333333333	NA
Carcharhinus porosus	128	NA
Carcharhinus sorrah	NA	NA
Carcharhinus tilstoni	NA	NA
Carcharodon carcharias	690.666666666667	NA
Careproctus melanurus	NA	NA
Caspiomyzon wagneri	55.3	NA
Cataetyx alleni	NA	NA
Catla catla	112.5	NA
Caulolatilus microps	NA	NA
Centrolabrus exoletus	NA	NA
Centropomus undecimalis	NA	NA
Centropristis striata	NA	NA
Cephalopholis cruentata	33	NA
Cephalopholis fulva	40	NA
Cephalopholis hemistiktos	NA	NA
Cepola macrophthalma	61.1666666666667	6.5
Cetengraulis edentulus	NA	NA
Cetengraulis mysticetus	16.2857142857143	NA
Cetorhinus maximus	942	NA
Cetostoma regani	NA	NA
Chaenocephalus aceratus	61.8333333333333	NA
Chaetodon miliaris	NA	NA
Champsocephalus gunnari	NA	NA
Chasmichthys dolichognathus	NA	NA
Chauliodus macouni	23	NA
Cheilinus undulatus	NA	NA
Cheilopogon atrisignis	NA	NA
Cheilopogon cyanopterus	NA	NA
Cheilopogon nigricans	NA	NA
Cheilotrema saturnum	44.1	NA
Cheimerius nufar	68.5	NA
Chelidonichthys capensis	70	NA
Chelidonichthys cuculus	24	NA
Chelidonichthys gurnardus	36	NA
Chelidonichthys kumu	55	NA
Chelidonichthys lastoviza	30	NA
Chelidonichthys lucerna	56	NA
Chelidonichthys queketti	NA	NA
Chelon labrosus	55	NA
Chilara taylori	NA	NA
Chirocentrus nudus	NA	NA
Chirostoma attenuatum	NA	NA
Chirostoma estor estor	NA	NA
Chirostoma grandocule	12.3	NA
Chirostoma humboldtianum	NA	NA
Chirostoma patzcuaro	NA	NA
Chloroscombrus chrysurus	NA	NA
Chlorurus gibbus	NA	NA
Chlorurus sordidus	NA	NA
Chologaster cornuta	NA	NA
Chondrostoma polylepis	NA	NA
Chromis ternatensis	NA	NA
Chrysichthys auratus auratus	57	NA
Chrysichthys nigrodigitatus	NA	NA
Chrysichthys walkeri	NA	NA
Chrysoblephus cristiceps	NA	NA
Chrysoblephus laticeps	50	NA
Chrysophrys auratus	130	NA
Cirrhinus chinensis	NA	NA
Cirrhinus cirrhosus	87.35	NA
Citharichthys sordidus	NA	NA
Citharinus citharus citharus	NA	NA
Citharus linguatula	NA	NA
Clarias gariepinus	104	NA
Clarias ngamensis	NA	NA
Cleisthenes herzensteini	NA	NA
Clinocottus analis	NA	NA
Clupea harengus	NA	10
Clupea pallasii	45	11.5
Clupeonella cultriventris	NA	NA
Coilia dussumieri	NA	NA
Coilia nasus	31	NA
Coilia reynaldi	NA	NA
Cololabis saira	NA	NA
Colossoma macropomum	NA	NA
Conger conger	180	NA
Contusus richei	NA	NA
Copadichromis likomae	13	NA
Copadichromis mloto	NA	NA
Copadichromis pleurostigmoides	14.4	NA
Copadichromis quadrimaculatus	19	NA
Copadichromis virginalis	12	NA
Coregonus albula	NA	NA
Coregonus artedi	NA	8.5
Coregonus clupeaformis	NA	25.5
Coregonus kiyi	NA	NA
Coregonus lavaretus	NA	NA
Coregonus macrophthalmus	NA	NA
Coregonus nasus	NA	NA
Coregonus oxyrinchus	NA	NA
Coregonus pollan	NA	NA
Coregonus sardinella	NA	11
Coryphaena equiselis	NA	NA
Coryphaena hippurus	166.5	NA
Coryphaenoides guentheri	NA	NA
Coryphaenoides mediterraneus	NA	NA
Coryphaenoides rupestris	NA	NA
Cottus asperrimus	8	5
Cottus beldingii	9	NA
Cottus gobio	NA	5
Ctenochaetus striatus	NA	NA
Ctenolabrus rupestris	NA	NA
Ctenopharyngodon idellus	110	NA
Ctenopharynx intermedius	22	NA
Culter erythropterus	NA	NA
Cycleptus meridionalis	64.75	NA
Cyclopsetta chittendeni	NA	NA
Cyclopterus lumpus	NA	NA
Cyclothone acclinidens	NA	NA
Cyema atrum	NA	NA
Cymatoceps nasutus	110	NA
Cynoglossus arel	NA	NA
Cynoglossus canariensis	NA	NA
Cynoglossus lida	NA	NA
Cynoglossus puncticeps	NA	NA
Cynoglossus semifasciatus	17	NA
Cynoglossus senegalensis	NA	NA
Cynoscion acoupa	NA	NA
Cynoscion analis	NA	NA
Cynoscion jamaicensis	NA	NA
Cynoscion leiarchus	NA	NA
Cynoscion nebulosus	NA	NA
Cynoscion nothus	NA	NA
Cynoscion regalis	NA	NA
Cynoscion stolzmanni	NA	NA
Cynoscion xanthulum	NA	NA
Cyprinus carpio carpio	85	NA
Cypselurus opisthopus	NA	NA
Dactyloptena orientalis	NA	NA
Dasyatis akajei	NA	NA
Dasyatis sabina	NA	NA
Decapterus kurroides	NA	NA
Decapterus macarellus	NA	NA
Decapterus macrosoma	19	NA
Decapterus maruadsi	23	NA
Decapterus punctatus	21	NA
Decapterus russelli	NA	NA
Dendrophysa russelii	NA	NA
Dentex angolensis	37	NA
Dentex canariensis	NA	NA
Dentex congoensis	23	NA
Dentex dentex	NA	NA
Dentex gibbosus	100	NA
Dentex macrophthalmus	34.5	NA
Dentex maroccanus	27	NA
Dentex tumifrons	NA	NA
Diagramma pictum	88.5	NA
Diaphus dumerilii	6	NA
Diapterus peruvianus	NA	NA
Diapterus rhombeus	NA	NA
Dicentrarchus labrax	48.85	NA
Dicentrarchus punctatus	NA	NA
Dichistius capensis	NA	NA
Dicologlossa cuneata	NA	NA
Diplectrum formosum	NA	NA
Diplodus annularis	NA	7
Diplodus bellottii	NA	NA
Diplodus cervinus hottentotus	50	NA
Diplodus sargus capensis	NA	NA
Diplodus sargus sargus	40	NA
Diplodus vulgaris	NA	NA
Dipturus batis	NA	NA
Distichodus rostratus	31.3	NA
Doederleinia berycoides	NA	NA
Dolichopteryx longipes	NA	NA
Drepane africana	45	NA
Drepane punctata	41	NA
Dussumieria acuta	18	NA
Dussumieria elopsoides	NA	NA
Edelia vittata	NA	NA
Elagatis bipinnulata	NA	NA
Elops saurus	NA	NA
Enchelyopus cimbrius	NA	NA
Encrasicholina devisi	7	NA
Encrasicholina heteroloba	7	NA
Encrasicholina punctifer	NA	NA
Encrasicholina purpurea	NA	NA
Enedrias nebulosus	28	NA
Engraulicypris sardella	13	NA
Engraulis anchoita	20.5	NA
Engraulis australis	15.7	NA
Engraulis encrasicolus	18.6666666666667	2.5
Engraulis japonicus	NA	2.75
Engraulis mordax	15.3333333333333	7
Engraulis ringens	19	3
Eopsetta grigorjewi	NA	NA
Eopsetta jordani	NA	NA
Epinephelus adscensionis	NA	NA
Epinephelus aeneus	115	NA
Epinephelus areolatus	41	NA
Epinephelus chlorostigma	71.5	NA
Epinephelus coioides	105.5	NA
Epinephelus costae	NA	NA
Epinephelus cyanopodus	NA	NA
Epinephelus diacanthus	51.4	NA
Epinephelus drummondhayi	NA	25
Epinephelus fasciatus	52	NA
Epinephelus fuscoguttatus	NA	NA
Epinephelus guttatus	56	NA
Epinephelus itajara	NA	NA
Epinephelus labriformis	32	NA
Epinephelus latifasciatus	121	NA
Epinephelus maculatus	NA	NA
Epinephelus marginatus	NA	50
Epinephelus merra	NA	NA
Epinephelus morio	NA	NA
Epinephelus multinotatus	100	NA
Epinephelus nigritus	200	NA
Epinephelus niveatus	NA	27
Epinephelus ongus	NA	NA
Epinephelus polylepis	74	NA
Epinephelus rivulatus	NA	NA
Epinephelus sexfasciatus	NA	NA
Epinephelus striatus	85	16
Epinephelus tauvina	107	NA
Eptatretus polytrema	NA	NA
Esox lucius	NA	NA
Esox masquinongy	165	NA
Esox reichertii	NA	NA
Etelis carbunculus	88.3333333333333	NA
Etelis coruscans	96	NA
Etelis oculatus	93	NA
Ethmalosa fimbriata	28	NA
Etrumeus teres	26	NA
Etrumeus whiteheadi	NA	NA
Eucinostomus gula	NA	NA
Eudontomyzon mariae	21.4	NA
Eugerres brasilianus	NA	NA
Eugerres plumieri	NA	NA
Euthynnus affinis	98.6666666666667	NA
Euthynnus alletteratus	97	NA
Evynnis japonica	NA	NA
Facciolella gilberti	NA	NA
Favonigobius lateralis	NA	NA
Forbesichthys agassizi	NA	NA
Forsterygion lapillum	NA	NA
Forsterygion varium	NA	NA
Fundulus parvipinnis	7.2	NA
Furgaleus macki	160	NA
Gadiculus argenteus argenteus	11	NA
Gadiculus argenteus thori	NA	NA
Gadus macrocephalus	NA	NA
Gadus morhua	132	14
Gaidropsarus mediterraneus	NA	NA
Galaxiella munda	NA	NA
Galaxiella nigrostriata	4	NA
Galaxiella pusilla	NA	NA
Galeocerdo cuvier	459.5	NA
Galeoides decadactylus	39	NA
Galeorhinus galeus	171.333333333333	55
Gambusia affinis	NA	NA
Gasterosteus aculeatus aculeatus	NA	4
Gazza minuta	NA	NA
Genypterus blacodes	147.75	NA
Genypterus capensis	150	NA
Gerres cinereus	NA	NA
Gerres filamentosus	NA	NA
Gerres oyena	40	NA
Gigantura indica	NA	NA
Ginglymostoma cirratum	NA	NA
Girella tricuspidata	71	NA
Glossanodon semifasciatus	NA	NA
Glossogobius giuris	17.5	NA
Glyptocephalus cynoglossus	NA	NA
Glyptocephalus kitaharai	NA	NA
Gnathanodon speciosus	81	NA
Gobionellus microdon	NA	NA
Gobionotothen gibberifrons	53	NA
Gobiosoma robustum	NA	NA
Gobius cobitis	NA	NA
Gobius niger	NA	NA
Gobius paganellus	NA	NA
Gymnapistes marmoratus	NA	NA
Gymnarchus niloticus	150	NA
Gymnelus viridis	20	NA
Gymnocanthus tricuspis	NA	NA
Gymnocephalus cernuus	NA	NA
Gymnocranius audleyi	31.9	NA
Gymnocranius euanus	NA	NA
Gymnocranius grandoculis	NA	NA
Haemulon album	NA	NA
Haemulon aurolineatum	NA	NA
Haemulon bonariense	NA	NA
Haemulon flavolineatum	NA	NA
Haemulon melanurum	NA	NA
Haemulon parra	NA	NA
Haemulon plumieri	NA	NA
Haemulon sciurus	NA	NA
Halichoeres poecilopterus	20	NA
Halichoeres radiatus	NA	NA
Hampala macrolepidota	NA	NA
Haplochromis macconneli	NA	NA
Harengula humeralis	NA	NA
Harengula jaguana	NA	NA
Harpadon nehereus	NA	NA
Helicolenus dactylopterus dactylopterus	26.5	NA
Hemichromis fasciatus	NA	NA
Hemiramphus brasiliensis	31	NA
Hepsetus odoe	37	NA
Herklotsichthys quadrimaculatus	NA	NA
Heterobranchus longifilis	115	NA
Heteropneustes fossilis	17.5	NA
Heterotis niloticus	NA	NA
Hexagrammos agrammus	NA	NA
Hilsa kelee	40	NA
Hippocampus erectus	NA	NA
Hippocampus zosterae	NA	NA
Hippoglossoides platessoides	NA	30
Hippoglossoides robustus	32.4	NA
Hippoglossus hippoglossus	NA	30
Hippoglossus stenolepis	NA	NA
Hippopotamyrus discorhynchus	32	NA
Hipposcarus longiceps	NA	NA
Hirundichthys affinis	24	NA
Holocentrus ascensionis	34	NA
Holocentrus rufus	23	NA
Hoplostethus atlanticus	44.35	NA
Hoplostethus mediterraneus mediterraneus	16.2	NA
Howella brodiei	NA	NA
Huso dauricus	NA	NA
Huso huso	NA	NA
Hydrocynus forskalii	58	NA
Hydrocynus vittatus	47	NA
Hydrolagus colliei	NA	NA
Hyperoglyphe antarctica	103	NA
Hyperprosopon anale	NA	NA
Hypodytes rubripinnis	NA	NA
Hypomesus olidus	NA	NA
Hypophthalmichthys molitrix	95.2	NA
Hypoptychus dybowskii	NA	NA
Hyporhamphus melanochir	NA	NA
Ichthyborus besse besse	NA	NA
Icosteus aenigmaticus	NA	NA
Ictalurus punctatus	NA	NA
Idiacanthus antrostomus	NA	NA
Ilisha africana	19	NA
Ilisha filigera	NA	NA
Isogomphodon oxyrhynchus	152	NA
Isopsetta isolepis	NA	NA
Istiophorus albicans	NA	NA
Istiophorus platypterus	300	NA
Isurus oxyrinchus	336	NA
Jenkinsia lamprotaenia	NA	NA
Johnius borneensis	NA	NA
Johnius carutta	25	NA
Johnius dussumieri	22.5	NA
Johnius macrorhynus	NA	NA
Kali normani	NA	NA
Karalepis stewarti	NA	NA
Kathetostoma averruncus	NA	NA
Katsuwonus pelamis	90.5	NA
Kyphosus cinerascens	NA	NA
Labeo coubie	39	NA
Labeo fimbriatus	NA	NA
Labeo gonius	72	NA
Labeo horie	NA	NA
Labeo niloticus	NA	NA
Labeo rohita	88	NA
Labeo senegalensis	NA	NA
Labidesthes sicculus	NA	NA
Labrus bergylta	46	NA
Labrus merula	NA	NA
Labrus mixtus	NA	NA
Lachnolaimus maximus	NA	NA
Lactarius lactarius	NA	NA
Lagocephalus sceleratus	NA	NA
Lagodon rhomboides	NA	NA
Lamna nasus	NA	NA
Lampanyctodes hectoris	7	NA
Lampetra planeri	NA	NA
Larimichthys polyactis	NA	NA
Larimus fasciatus	NA	NA
Lateolabrax japonicus	NA	NA
Lates calcarifer	190	NA
Lates longispinis	NA	NA
Lates niloticus	NA	NA
Lates stappersii	NA	NA
Latimeria chalumnae	NA	NA
Latridopsis ciliaris	80	NA
Leiognathus bindus	14	NA
Leiognathus blochii	NA	NA
Leiognathus brevirostris	NA	NA
Leiognathus daura	NA	NA
Leiognathus decorus	NA	NA
Leiognathus elongatus	NA	NA
Leiognathus equulus	21.5	NA
Leiognathus leuciscus	NA	NA
Leiognathus lineolatus	NA	NA
Leiognathus nuchalis	NA	NA
Leiognathus splendens	NA	2.3
Leiopotherapon plumbeus	NA	NA
Leiostomus xanthurus	NA	NA
Lepidion lepidion	NA	NA
Lepidogobius lepidus	88	NA
Lepidonotothen kempi	NA	NA
Lepidonotothen larseni	NA	NA
Lepidonotothen squamifrons	43	NA
Lepidophanes guentheri	6	NA
Lepidopsetta bilineata	NA	NA
Lepidopus caudatus	NA	NA
Lepidorhombus boscii	35	NA
Lepidorhombus whiffiagonis	47	NA
Lepidotrigla cavillone	16	NA
Lepisosteus osseus	NA	NA
Lepomis gibbosus	30	NA
Lepomis macrochirus	NA	NA
Lepomis megalotis	NA	NA
Leptoscarus vaigiensis	NA	NA
Lepturacanthus savala	NA	NA
Lestidium ringens	NA	NA
Lesueurigobius friesii	9	NA
Lethrinops longipinnis	22.6	NA
Lethrinops parvidens	20.4	NA
Lethrinus atkinsoni	NA	NA
Lethrinus enigmaticus	49	NA
Lethrinus erythracanthus	NA	NA
Lethrinus genivittatus	NA	NA
Lethrinus harak	NA	NA
Lethrinus lentjan	50.5	NA
Lethrinus mahsena	NA	NA
Lethrinus microdon	NA	NA
Lethrinus miniatus	90	NA
Lethrinus nebulosus	77.4	20
Lethrinus obsoletus	NA	NA
Lethrinus olivaceus	85	NA
Lethrinus ornatus	NA	NA
Lethrinus rubrioperculatus	NA	NA
Lethrinus semicinctus	NA	NA
Lethrinus variegatus	NA	NA
Lethrinus xanthochilus	NA	NA
Leuciscus cephalus	NA	NA
Leucoraja erinacea	54	NA
Leucoraja naevus	NA	NA
Leuresthes tenuis	NA	3
Lile stolifera	NA	NA
Limanda aspera	NA	NA
Limanda ferruginea	NA	NA
Limanda limanda	NA	NA
Limnothrissa miodon	10	NA
Liparis inquilinus	NA	NA
Liparis pulchellus	NA	NA
Lipophrys pholis	NA	6
Lithognathus aureti	80	NA
Lithognathus lithognathus	NA	NA
Lithognathus mormyrus	NA	NA
Liza aurata	NA	NA
Liza grandisquamis	46	NA
Liza macrolepis	NA	NA
Liza parsia	NA	NA
Liza ramada	NA	NA
Liza saliens	NA	NA
Liza subviridis	NA	NA
Liza tade	NA	NA
Lobianchia dofleini	NA	NA
Lophius americanus	101	NA
Lophius budegassa	51	NA
Lophius piscatorius	90	NA
Lophius vomerinus	NA	NA
Lopholatilus chamaeleonticeps	103.5	30.5
Lota lota	NA	NA
Lumpenus lampretaeformis	34.5	NA
Lutjanus adetii	NA	24
Lutjanus analis	NA	NA
Lutjanus apodus	54	NA
Lutjanus argentimaculatus	150	NA
Lutjanus argentiventris	NA	NA
Lutjanus bohar	NA	NA
Lutjanus buccanella	73	NA
Lutjanus campechanus	89	13
Lutjanus carponotatus	NA	NA
Lutjanus cyanopterus	102	NA
Lutjanus erythropterus	72.8	NA
Lutjanus fulviflammus	NA	NA
Lutjanus gibbus	NA	NA
Lutjanus griseus	NA	NA
Lutjanus jocu	NA	NA
Lutjanus johnii	NA	NA
Lutjanus kasmira	40	NA
Lutjanus lutjanus	NA	NA
Lutjanus malabaricus	81.5	10
Lutjanus monostigma	NA	NA
Lutjanus purpureus	NA	NA
Lutjanus quinquelineatus	NA	31
Lutjanus rivulatus	NA	NA
Lutjanus sanguineus	88	NA
Lutjanus sebae	108	NA
Lutjanus synagris	41	6
Lutjanus vitta	NA	NA
Lutjanus vivanus	NA	NA
Lycodes pacificus	NA	NA
Lycodes vahlii	NA	NA
Maccullochella peelii peelii	160	NA
Macquaria ambigua	75	NA
Macquaria novemaculeata	47	NA
Macrodon ancylodon	NA	NA
Macroramphosus gracilis	13.5	NA
Macroramphosus scolopax	17.25	NA
Macruronus magellanicus	115	NA
Macruronus novaezelandiae	122.5	NA
Makaira indica	430	NA
Makaira mazara	NA	NA
Makaira nigricans	400	NA
Mallotus villosus	NA	5
Maravichromis anaphyrmus	20	NA
Marcusenius macrolepidotus	30	NA
Marcusenius monteiri	NA	NA
Maurolicus muelleri	NA	NA
Megalaspis cordyla	50	NA
Megalops atlanticus	205	NA
Melanogrammus aeglefinus	74.5	16
Mene maculata	NA	NA
Menidia extensa	NA	NA
Menidia menidia	NA	NA
Menticirrhus saxatilis	NA	NA
Menticirrhus undulatus	NA	NA
Merlangius merlangus	NA	NA
Merluccius angustimanus	39	7
Merluccius australis	112	NA
Merluccius bilinearis	NA	12
Merluccius capensis	110	NA
Merluccius gayi gayi	NA	NA
Merluccius gayi peruanus	NA	13
Merluccius hubbsi	77	NA
Merluccius merluccius	58	10
Merluccius paradoxus	NA	NA
Merluccius polli	NA	NA
Merluccius productus	NA	NA
Merluccius senegalensis	NA	NA
Micralestes acutidens	NA	NA
Microchirus theophila	32.3	NA
Microgobius thalassinus	NA	NA
Micromesistius australis	NA	30
Micromesistius poutassou	29.5	9
Micrometrus aurora	NA	NA
Micropogonias furnieri	66	NA
Micropogonias undulatus	38.55	NA
Micropterus dolomieui	NA	14
Micropterus salmoides	NA	NA
Microstomus achne	NA	NA
Microstomus kitt	53.1428571428571	NA
Microstomus pacificus	NA	NA
Miichthys miiuy	NA	NA
Mistichthys luzonensis	2	NA
Molva dypterygia	NA	NA
Molva molva	NA	NA
Monocentris reedi	9.9	NA
Monochirus hispidus	13	NA
Mormyrops anguilloides	100	NA
Mormyrus longirostris	80	NA
Mormyrus rume	NA	NA
Morone americana	NA	NA
Morone chrysops	NA	NA
Morone saxatilis	NA	NA
Morulius calbasu	65	NA
Mugil cephalus	78	NA
Mugil curema	29	NA
Mugil gyrans	NA	NA
Mugil hospes	NA	NA
Mugil liza	NA	NA
Mugil soiuy	NA	NA
Mulloidichthys flavolineatus	NA	NA
Mulloidichthys martinicus	NA	NA
Mulloidichthys vanicolensis	NA	NA
Mullus barbatus	21.35	NA
Mullus surmuletus	26	8
Mustelus antarcticus	160	NA
Mustelus californicus	163	NA
Mustelus canis	NA	NA
Mustelus henlei	100	NA
Mustelus lenticulatus	NA	NA
Mustelus manazo	NA	NA
Mycteroperca bonaci	124	NA
Mycteroperca microlepis	107	NA
Mycteroperca olfax	94	NA
Mycteroperca phenax	NA	NA
Mycteroperca tigris	101	NA
Mycteroperca venenosa	88.5	15
Myctophum nitidulum	NA	NA
Myctophum punctatum	NA	NA
Mylopharyngodon piceus	NA	NA
Myoxocephalus octodecemspinosus	NA	NA
Myoxocephalus scorpius	NA	NA
Naso lituratus	NA	NA
Naso unicornis	NA	NA
Naucrates ductor	34	NA
Negaprion brevirostris	NA	NA
Nemadactylus macropterus	47.5	50
Nematalosa vlaminghi	36	NA
Nemichthys scolopaceus	NA	NA
Nemipterus bathybius	NA	NA
Nemipterus bipunctatus	NA	NA
Nemipterus furcosus	NA	NA
Nemipterus hexodon	NA	NA
Nemipterus japonicus	29.9142857142857	3.3
Nemipterus marginatus	23	NA
Nemipterus mesoprion	NA	NA
Nemipterus nematophorus	NA	NA
Nemipterus nemurus	NA	NA
Nemipterus peronii	NA	NA
Nemipterus randalli	21	NA
Nemipterus thosaporni	23	5
Nemipterus virgatus	NA	NA
Neobola stellae	NA	NA
Nerophis ophidion	29	NA
Nezumia sclerorhynchus	NA	NA
Nezumia stelgidolepis	NA	NA
Nibea maculata	NA	NA
Notolabrus celidotus	NA	NA
Notolabrus fucicola	NA	NA
Notolychnus valdiviae	NA	NA
Notoscopelus elongatus	NA	NA
Notothenia coriiceps	NA	18
Notothenia cyanobrancha	NA	NA
Notothenia rossii	90	NA
Notropis atherinoides	NA	NA
Ocyurus chrysurus	60.15	14
Odontesthes regia	NA	NA
Okamejei hollandi	NA	NA
Oligocottus maculosus	NA	NA
Oncorhynchus keta	NA	5
Oncorhynchus kisutch	98	NA
Oncorhynchus masou masou	25.5	NA
Oncorhynchus nerka	NA	NA
Oneirodes acanthias	NA	NA
Ophichthus zophochir	NA	NA
Ophiodon elongatus	NA	NA
Opisthonema libertate	NA	NA
Opisthonema oglinum	30	NA
Opsanus tau	NA	NA
Oreochromis andersonii	NA	NA
Oreochromis aureus	NA	NA
Oreochromis esculentus	NA	NA
Oreochromis karongae	34	NA
Oreochromis leucostictus	NA	NA
Oreochromis lidole	38	NA
Oreochromis macrochir macrochir	40.2	NA
Oreochromis mortimeri	48	NA
Oreochromis mossambicus	33.2857142857143	NA
Oreochromis niloticus niloticus	52	NA
Oreochromis saka	NA	NA
Oreochromis shiranus shiranus	NA	NA
Oreochromis squamipinnis	33	NA
Oreochromis variabilis	NA	NA
Osmerus eperlanus	32	NA
Osmerus mordax mordax	NA	NA
Osteochilus hasseltii	25	NA
Otolithes cuvieri	NA	NA
Otolithes ruber	62	NA
Otolithoides biauritus	NA	NA
Oxyporhamphus convexus	NA	NA
Oxyporhamphus micropterus micropterus	NA	NA
Pachymetopon aeneum	40	NA
Pachymetopon blochii	35	NA
Pachymetopon grande	70	NA
Pagellus acarne	36	7
Pagellus affinis	37	NA
Pagellus bellottii bellottii	30	NA
Pagellus bellottii natalensis	35	NA
Pagellus bogaraveo	53	NA
Pagellus erythrinus	33	NA
Pagrus caeruleostictus	39.6666666666667	NA
Pagrus major	NA	NA
Pagrus pagrus	55.3333333333333	NA
Pampus argenteus	NA	NA
Pampus chinensis	NA	NA
Pangasius pangasius	NA	NA
Papyrocranus afer	NA	NA
Parabramis pekinensis	NA	NA
Paracanthobrama guichenoti	NA	NA
Paralabrax clathratus	NA	NA
Paralichthys dentatus	NA	NA
Paralichthys lethostigma	NA	NA
Paranotothenia magellanica	NA	NA
Paranthias furcifer	36	NA
Parapercis colias	NA	NA
Parapercis hexophtalma	NA	NA
Parapristipoma trilineatum	NA	NA
Parascolopsis inermis	NA	NA
Parastromateus niger	NA	NA
Parexocoetus brachypterus	NA	NA
Parophrys vetula	NA	NA
Parupeneus barberinus	NA	NA
Patagonotothen ramsayi	NA	NA
Pellona ditchela	NA	NA
Pellonula leonensis	6.7	NA
Pempheris adspersus	NA	NA
Pennahia anea	NA	NA
Pennahia argentata	NA	NA
Pentanemus quinquarius	NA	NA
Pentaprion longimanus	NA	NA
Peprilus burti	19	NA
Peprilus triacanthus	NA	NA
Perca flavescens	NA	NA
Perca fluviatilis	NA	NA
Perca schrenkii	NA	NA
Periophthalmus barbarus	NA	NA
Petrocephalus bovei bovei	11	NA
Petrocephalus catostoma catostoma	NA	NA
Petromyzon marinus	83.8	NA
Petrus rupestris	NA	NA
Pharyngochromis darlingi	10	NA
Phoxinus phoxinus	NA	NA
Phycis blennoides	50	NA
Phycis phycis	NA	NA
Piaractus brachypomus	NA	NA
Plagioscion squamosissimus	50	NA
Platichthys bicoloratus	NA	NA
Platichthys flesus	52.5	12
Platichthys stellatus	NA	NA
Platycephalus bassensis	NA	NA
Platycephalus caeruleopunctatus	NA	NA
Platycephalus indicus	83.5	NA
Platycephalus richardsoni	62	NA
Platycephalus speculator	NA	NA
Plectorhinchus gibbosus	NA	NA
Plectorhinchus goldmanni	NA	NA
Plectorhinchus mediterraneus	NA	NA
Plectorhinchus nigrus	NA	NA
Plectorhinchus pictus	68.5	NA
Plectorhinchus picus	NA	NA
Plectropomus leopardus	120	14
Plectropomus maculatus	76	NA
Pleuragramma antarcticum	25	NA
Pleurogrammus monopterygius	NA	NA
Pleuronectes platessus	NA	30
Pleuronectes quadrituberculatus	NA	NA
Pleuronichthys cornutus	NA	NA
Plotosus lineatus	NA	NA
Pogonias cromis	NA	NA
Pollachius pollachius	NA	NA
Pollachius virens	NA	25
Polydactylus indicus	NA	NA
Polydactylus multiradiatus	NA	NA
Polydactylus quadrifilis	NA	NA
Polymixia yuri	18.8	NA
Polyodon spathula	152	30
Polypterus senegalus senegalus	NA	NA
Polysteganus undulosus	100	NA
Pomacanthus paru	NA	NA
Pomacentrus moluccensis	NA	NA
Pomacentrus wardi	NA	NA
Pomadasys argenteus	58	NA
Pomadasys argyreus	NA	NA
Pomadasys commersonnii	80	NA
Pomadasys jubelini	NA	NA
Pomadasys kaakan	NA	NA
Pomadasys maculatus	59	NA
Pomadasys opercularis	NA	NA
Pomadasys striatus	15	NA
Pomatomus saltator	103	9
Pomatoschistus microps	NA	NA
Pomatoschistus minutus	NA	2
Pomoxis nigromaculatus	NA	NA
Potamalosa richmondia	NA	NA
Priacanthus arenatus	NA	NA
Priacanthus hamrur	34.1	NA
Priacanthus macracanthus	28	NA
Priacanthus tayenus	NA	NA
Prionace glauca	295.75	NA
Prionotus stephanophrys	NA	NA
Pristipomoides auricilla	NA	NA
Pristipomoides filamentosus	74.75	18
Pristipomoides flavipinnis	NA	NA
Pristipomoides multidens	63.75	NA
Pristipomoides sieboldii	NA	NA
Pristipomoides typus	47	NA
Pristipomoides zonatus	NA	NA
Prochilodus magdalenae	50	NA
Prochilodus nigricans	42	NA
Prochilodus reticulatus	NA	NA
Prosopium williamsoni	NA	NA
Protonibea diacanthus	122	NA
Prototroctes maraena	NA	NA
Psettodes erumei	53.6666666666667	NA
Pseudanthias squamipinnis	NA	NA
Pseudobalistes flavimarginatus	NA	NA
Pseudobarbus afer	10.2	NA
Pseudobarbus asper	11.7	NA
Pseudocaranx dentex	89.3333333333333	NA
Pseudochaenichthys georgianus	NA	NA
Pseudocrenilabrus philander philander	8	NA
Pseudocyttus maculatus	NA	NA
Pseudophycis bachus	NA	NA
Pseudoplatystoma fasciatum	100	NA
Pseudoplatystoma tigrinum	130	NA
Pseudopleuronectes americanus	39.6666666666667	10
Pseudopleuronectes herzensteini	NA	NA
Pseudopleuronectes yokohamae	NA	NA
Pseudorhombus arsius	38	NA
Pseudorhombus cinnamoneus	NA	NA
Pseudorhombus javanicus	NA	NA
Pseudoscaphirhynchus kaufmanni	NA	NA
Pseudotolithus elongatus	45.5	NA
Pseudotolithus senegalensis	61	NA
Pseudotolithus typus	89.3333333333333	NA
Pseudotriakis microdon	NA	NA
Pseudupeneus maculatus	25	NA
Pseudupeneus prayensis	NA	NA
Pterocaesio pisang	NA	NA
Pterogymnus laniarius	45	NA
Pungitius pungitius pungitius	NA	NA
Puntius chola	NA	NA
Puntius dorsalis	NA	NA
Puntius sarana	NA	NA
Pygocentrus nattereri	26.25	NA
Rachycentron canadum	144.666666666667	NA
Raconda russeliana	NA	NA
Raiamas moorii	21	NA
Raja brachyura	113.5	NA
Raja clavata	90	NA
Raja eglanteria	NA	NA
Raja microocellata	NA	NA
Raja miraletus	NA	NA
Raja montagui	68.5	NA
Raja rhina	NA	NA
Rasbora daniconius	NA	NA
Rastrelliger brachysoma	25.5	2
Rastrelliger faughni	NA	NA
Rastrelliger kanagurta	30	NA
Rastrineobola argentea	NA	NA
Reinhardtius hippoglossoides	NA	NA
Retropinna semoni	NA	NA
Rexea solandri	104	NA
Rhabdamia gracilis	NA	NA
Rhabdosargus globiceps	50	NA
Rhincodon typus	NA	NA
Rhizoprionodon acutus	98.5	NA
Rhizoprionodon taylori	73.75	NA
Rhizoprionodon terraenovae	NA	NA
Rhodeus ocellatus ocellatus	NA	NA
Rhomboplites aurorubens	NA	NA
Rhombosolea plebeia	NA	NA
Rhynchorhamphus georgii	NA	NA
Roncador stearnsii	NA	NA
Rondeletia loricata	NA	NA
Rudarius ercodes	6.6	NA
Rutilus lemmingii	NA	NA
Rutilus rutilus	NA	NA
Sagamichthys abei	NA	NA
Salaria pavo	NA	NA
Salmo salar	NA	5.5
Salmo trutta trutta	69.6666666666667	8
Salvelinus alpinus	NA	24
Salvelinus namaycush	NA	25
Sander lucioperca	NA	NA
Sarda chiliensis chiliensis	79	NA
Sarda chiliensis lineolata	96.5	NA
Sarda orientalis	87.75	NA
Sarda sarda	82.525	NA
Sardina pilchardus	19.85	8
Sardinella albella	16	NA
Sardinella aurita	32.3333333333333	7
Sardinella brasiliensis	NA	NA
Sardinella fimbriata	18	NA
Sardinella gibbosa	21	NA
Sardinella lemuru	19.5	NA
Sardinella longiceps	22	4
Sardinella maderensis	24	NA
Sardinella melanura	21	NA
Sardinops sagax	30	13
Sargocentron diadema	NA	NA
Sargocentron microstoma	NA	NA
Sarotherodon galilaeus galilaeus	NA	NA
Sarotherodon melanotheron melanotheron	25	NA
Saurida elongata	NA	NA
Saurida longimanus	NA	NA
Saurida micropectoralis	NA	NA
Saurida tumbil	60	7
Saurida undosquamis	49.5	NA
Scarus coeruleus	NA	NA
Scarus frenatus	NA	NA
Scarus guacamaia	NA	NA
Scarus niger	NA	NA
Scarus psittacus	NA	NA
Scarus schlegeli	NA	NA
Scarus vetula	50	NA
Scatophagus argus	NA	NA
Schilbe intermedius	NA	NA
Schilbe mystus	33.05	NA
Schilbe uranoscopus	29.5	NA
Sciadeops troschelii	NA	NA
Sciaena umbra	NA	NA
Sciaenops ocellatus	NA	NA
Scoliodon laticaudus	NA	NA
Scolopsis lineatus	NA	NA
Scomber australasicus	NA	NA
Scomber japonicus	52	9
Scomberoides lysan	NA	NA
Scomberomorus brasiliensis	125	NA
Scomberomorus cavalla	159.333333333333	14
Scomberomorus commerson	211	NA
Scomberomorus guttatus	70	NA
Scomberomorus lineolatus	96	NA
Scomberomorus maculatus	80	NA
Scomberomorus niphonius	NA	NA
Scomberomorus regalis	NA	NA
Scomberomorus tritor	NA	NA
Scomber scombrus	50	NA
Scombrops boops	99	NA
Scombrops gilberti	66	NA
Scopelengys tristis	20	NA
Scopelosaurus harryi	NA	NA
Scophthalmus aquosus	NA	NA
Scophthalmus maximus	NA	NA
Scophthalmus rhombus	NA	NA
Scorpaena guttata	NA	NA
Scorpaena porcus	27.25	NA
Scorpaena scrofa	NA	NA
Scorpaenichthys marmoratus	NA	NA
Scyliorhinus canicula	56.5	NA
Sebastes alutus	41	72
Sebastes caurinus	NA	NA
Sebastes emphaeus	17.8	13
Sebastes flavidus	NA	NA
Sebastes goodei	NA	NA
Sebastes inermis	NA	NA
Sebastes jordani	NA	NA
Sebastes marinus	NA	NA
Sebastes melanops	NA	NA
Sebastes mentella	NA	NA
Sebastes mystinus	NA	NA
Sebastes pachycephalus	NA	NA
Sebastes paucispinis	NA	NA
Sebastes polyspinis	NA	NA
Sebastes viviparus	NA	NA
Sebastiscus marmoratus	NA	NA
Secutor insidiator	NA	NA
Secutor ruconius	NA	NA
Selar boops	NA	NA
Selar crumenophthalmus	NA	NA
Selaroides leptolepis	19	NA
Selene dorsalis	NA	NA
Seriola dumerili	NA	NA
Seriola lalandi	200	NA
Seriola quinqueradiata	NA	NA
Seriolella brama	76	NA
Serranochromis angusticeps	NA	NA
Serranochromis codringtonii	39	NA
Serranochromis mellandi	NA	NA
Serranochromis robustus robustus	NA	NA
Serranus cabrilla	NA	NA
Serranus scriba	NA	NA
Serranus subligarius	NA	NA
Serrivomer sector	NA	NA
Setipinna taty	NA	NA
Siganus argenteus	NA	NA
Siganus canaliculatus	NA	NA
Siganus fuscescens	NA	NA
Siganus lineatus	NA	NA
Siganus rivulatus	40	NA
Siganus sutor	NA	NA
Siganus vermiculatus	NA	NA
Sillaginopsis panijus	NA	NA
Sillago bassensis	NA	NA
Sillago ciliata	50	NA
Sillago robusta	NA	NA
Sillago schomburgkii	NA	NA
Sillago sihama	NA	NA
Silurus glanis	500	NA
Siniperca chuatsi	NA	NA
Solea solea	35	NA
Sparidentex hasta	83	NA
Sparisoma aurofrenatum	NA	NA
Sparisoma chrysopterum	NA	NA
Sparisoma cretense	NA	NA
Sparisoma rubripinne	NA	NA
Sparisoma viride	53	NA
Sparodon durbanensis	120	NA
Sparus auratus	NA	11
Sperata aor	62	NA
Sphoeroides maculatus	NA	NA
Sphoeroides testudineus	30	NA
Sphyraena argentea	NA	NA
Sphyraena barracuda	180	NA
Sphyraena jello	139	NA
Sphyraena obtusata	39	NA
Sphyraena putnamae	NA	NA
Sphyrna lewini	301	NA
Sphyrna tiburo	124	NA
Spicara maena	15.75	NA
Spicara smaris	18.5	NA
Spinachia spinachia	16	NA
Spondyliosoma cantharus	NA	NA
Spratelloides delicatulus	NA	NA
Spratelloides gracilis	6	0.5
Spratelloides lewisi	NA	NA
Sprattus fuegensis	17.75	NA
Sprattus sprattus	15	6
Squaliobarbus curriculus	NA	NA
Squalus acanthias	108	NA
Squalus blainville	NA	NA
Squatina californica	152	NA
Stegastes nigricans	NA	NA
Stegastes planifrons	NA	NA
Stenobrachius leucopsarus	NA	NA
Stenotomus chrysops	37	NA
Stizostedion canadense	NA	13
Stizostedion vitreum	NA	NA
Stolephorus commersonii	NA	NA
Stolephorus indicus	NA	NA
Stolephorus insularis	7	NA
Stolephorus nelsoni	NA	NA
Stolephorus tri	NA	NA
Stolothrissa tanganicae	NA	NA
Stomias atriventer	NA	NA
Strangomera bentincki	NA	NA
Symbolophorus californiensis	13	NA
Symphodus cinereus	NA	NA
Symphodus mediterraneus	NA	NA
Symphodus melops	19.5	NA
Symphodus ocellatus	NA	NA
Symphodus roissali	NA	NA
Symphodus rostratus	NA	NA
Symphodus tinca	NA	NA
Symphorus nematophorus	NA	NA
Symphurus ligulatus	NA	NA
Synaptura kleinii	35.5	NA
Syngnathus rostellatus	19	NA
Syngnathus typhle	NA	NA
Synodontis batensoda	NA	NA
Synodontis budgetti	40	NA
Synodontis gambiensis	NA	NA
Synodontis membranaceus	NA	NA
Synodontis nigromaculatus	NA	NA
Synodontis resupinatus	NA	NA
Synodontis schall	35	NA
Tandanus tandanus	NA	NA
Taurulus bubalis	15	NA
Tautoga onitis	75.5	NA
Tautogolabrus adspersus	NA	NA
Tenualosa ilisha	NA	NA
Tenualosa reevesii	NA	NA
Tenualosa toli	NA	NA
Terapon theraps	NA	NA
Tetragonurus cuvieri	NA	NA
Tetrapturus albidus	NA	NA
Tetrapturus audax	307.5	NA
Theragra chalcogramma	NA	10
Thryssa hamiltonii	NA	NA
Thryssa mystax	20.5	NA
Thryssa vitrirostris	20	NA
Thunnus alalunga	127.4	NA
Thunnus albacares	182.5	5
Thunnus atlanticus	100	NA
Thunnus maccoyii	212.666666666667	20
Thunnus obesus	220.25	NA
Thunnus thynnus	302	NA
Thunnus tonggol	136	NA
Thymallus arcticus arcticus	52.8	NA
Thymallus brevirostris	NA	NA
Thymallus thymallus	NA	NA
Thyrsites atun	110	NA
Tilapia brevimanus	NA	NA
Tilapia guineensis	32	NA
Tilapia mariae	NA	NA
Tilapia rendalli	39	NA
Tilapia sparrmanii	NA	NA
Tilapia zillii	26	NA
Tinca tinca	NA	NA
Torpedo torpedo	NA	NA
Tor putitora	NA	NA
Totoaba macdonaldi	NA	15
Trachinocephalus myops	NA	NA
Trachurus capensis	NA	NA
Trachurus declivis	51	NA
Trachurus indicus	26.5	NA
Trachurus japonicus	31.7	6
Trachurus mediterraneus	26	NA
Trachurus murphyi	63	NA
Trachurus novaezelandiae	NA	NA
Trachurus symmetricus	60	NA
Trachurus trachurus	47.75	NA
Trachurus trecae	NA	NA
Trachyrincus scabrus	NA	NA
Trematomus bernacchii	21.5	NA
Trematomus hansoni	NA	NA
Triacanthus biaculeatus	NA	NA
Triakis semifasciata	136	NA
Trichiurus lepturus	166.75	NA
Trigla lyra	NA	NA
Trisopterus esmarkii	21	NA
Trisopterus luscus	NA	NA
Trisopterus minutus	27.5	5
Tristramella simonis intermedia	NA	NA
Tristramella simonis simonis	NA	NA
Tylochromis bangwelensis	NA	NA
Tylochromis jentinki	NA	NA
Typhlichthys subterraneus	NA	NA
Ulvaria subbifurcata	15.3	NA
Umbrina canariensis	NA	NA
Umbrina canosai	NA	NA
Umbrina cirrosa	NA	NA
Umbrina ronchus	NA	NA
Upeneus moluccensis	NA	NA
Upeneus sulphureus	NA	NA
Upeneus tragula	NA	NA
Upeneus vittatus	NA	NA
Uraspis helvola	NA	NA
Urobatis halleri	NA	NA
Urophycis chuss	NA	NA
Urophycis tenuis	NA	NA
Valamugil buchanani	NA	NA
Valamugil cunnesius	35	NA
Variola louti	NA	NA
Verasper variegatus	NA	NA
Xeneretmus latifrons	NA	NA
Xenocypris argentea	NA	NA
Xiphias gladius	200	NA
Xyrichtys novacula	NA	NA
Zalieutes elater	NA	NA
Zaniolepis frenata	NA	NA
Zeus faber	62.5	NA
Zoarces americanus	NA	NA
